01111111111111111111
01000000000000000010
01000000000000001110
01000000000000001010
01000001111111111010
01000001000000000010
01000001000000000010
01000001000000000010
01000001000000000010
01000001000000000010
01000001000000000010
01000001000000000010
01000001000000000010
01000001000000000010
01000001000000000010
01011111000000000010
01010000000000000010
01110000000000000010
01111111111111111110
11000000000000000000
