00000000000000000000
00000000000000000000
00000000000000000000
00000000000000000000
00000100000000000000
00000111111110000000
00000100000100000000
00000100000100000000
00000100000100000000
00000100000100000000
00000100000100000000
00000100000100000000
00000100000100000000
00001100000100000000
11111110111111111111
00010001000000000000
00010001000000000000
00011111000000000000
00000000000000000000
00000000000000000000
