11111111111111111111
10000000000011111111
10211011111011111111
10100010001011111111
10101111101011311111
10101000001011111111
10111011111011111111
10001000000011111111
11101111111011111111
10001010001000111111
10111010101101111111
10000010101000111111
11111110111010111111
10000010100010111111
11111110101110011111
10000000101011111111
10111111101011111111
10100100001011111111
10000111111111111111
11111101111111111111
